11111111
1PCKKKK1
1CC000K1
1K0C00K1
1K00C0K1
1K000CC1
1KKKKCE1
11111111