11111111111
1ECCCCCCCC1
10C000000C1
10C0CCCC0C1
10C0CP0C0C1
10C0CC0C0C1
10C0000C0C1
10CCCCCC0C1
100000000C1
11111111111