111111111
101000001
10P101E01
100011C01
111111111