1111111111
10100000K1
10P101E001
100001C001
1111111111