111111111
101000001
10P101E01
100001C01
111111111