111111111111111111
1E0100000000K00001
1K0100C000C00KKK01
1000000K10K00000K1
101C00000100000001
100000C000000000C1
100000011010000001
111C000K00000C0K01
1P0000000C00010001
111111111111111111
