1111111
1PEKKK1
1CCKKK1
1KKKKK1
1KKKKK1
1111111
